BAUSASTRA
Bawera :amba banget
Mungup - mungup : ketok arep metu
Bang wetan : sisih wetan
Manclab : sumurub/wayahe surub
Pindha : Kaya
Manca : Luar negeri
Diwangun : dibangun
Kepener : tumuju ing
Mudha : enom
Lindhu : gempa
Kapisan : kaping siji
Srawung : kekancan
Pilar : tugu
Mupu : ngepek anak
Kandheg : mandheg
Satriya : wong luhur
Suwita : ngenger
Nilapake : nglimpekake
Bali : mulih
Senjata cakra : senjata Bathara Wisnu
Ninjo : niliki
Bawera : jembar
Nyengguti : nyrempengi
Dumadine : kedadean
Jembar ngilak - ngilak : amba banget
Pandeleng : kang dienggo ndeleng (mripat)
Klaras : godong gedhang garing
Sasenggaman : kasanggupan
Pindha : kaya
Sraya : pitulungan
Ditigas gulune : ditugel gulune
Titihan : tumpakan
Wewengkon : daerah panguwasane
Judheg : bingung
Palilah : ijin
Mentas : lagi wae
Adreng : pingin tenanan
Ngoyak : diuber
Ngece : ngina
Regejengan : gegeran
Nyilakani : gawe cilaka
Tarung : tandhing
Suthik : ora gelem
Nggladhi : latihan
Tlatah : wilayah
Nggegiris : nggilani
Salah kaprah : salah naning akeh sing nggunakake
Kadakwa : katuduh
Kauja - uja : diunggul - unggulake
Mawas diri : intropeksi
Tinemu : ditemu
Nastiti : saktenane
